 A   -   -   -   -   -   -   -   -   -   -   -   -   -   -   W   -   -   W   - 
 -   -   W   -   -   -   -   -   -   W   -   W   -   -   -   -   -   -   -   - 
 -   W   -   -   -   -   -   -   -   W   -   -   -   -   -   -   -   -   -   - 
 -   -   -   -   -   -   F   -   -   -   -   -   -   -   -   -   -   -   -   - 
 -   -   -   -   -   W   -   -   W   W   -   -   -   W   -   W   W   -   -   - 
 -   -   -   -   W   -   -   W   -   -   -   -   -   W   -   -   -   -   -   - 
 -   -   -   -   W   -   -   -   -   -   -   -   -   -   -   -   -   -   -   - 
 -   W   -   -   -   -   -   -   -   -   -   -   -   W   W   W   -   -   -   W 
 -   -   -   -   W   -   -   -   -   -   -   -   -   W   -   W   -   W   -   - 
 -   -   -   -   -   -   -   -   -   -   -   -   -   W   -   W   -   W   W   W 
 -   -   W   -   -   -   -   -   -   -   W   -   -   -   -   -   -   -   -   - 
 -   -   -   W   -   -   -   -   -   -   W   -   -   -   -   -   -   -   -   - 
 -   -   -   -   -   -   -   W   -   -   -   -   -   -   -   -   -   -   -   - 
 -   W   -   -   -   -   -   -   -   -   -   -   W   -   -   -   -   -   -   - 
 -   -   -   -   W   W   -   W   -   -   -   -   -   -   -   -   -   -   -   - 
 -   W   -   -   W   W   -   -   -   -   -   W   -   -   -   F   -   -   W   - 
 -   -   -   -   -   -   -   -   -   -   -   -   -   -   -   -   -   -   -   - 
 -   W   -   -   -   -   -   -   -   -   -   -   W   -   -   -   -   -   W   W 
 -   W   -   -   -   -   W   -   -   -   -   -   -   -   -   -   -   -   -   - 
 -   -   -   -   -   -   -   -   W   -   -   -   -   -   -   -   -   -   -   - 
